00 00 00 00 00 00 00 00 00 00 00 00 00 00 00 00 00 00 00 00 00 00 00 00 00 00 00 00 00 00 00 00 00 00
00 20 20 20 20 20 20 20 20 20 20 20 20 20 20 20 10 10 20 20 60 20 20 20 20 20 20 20 20 20 20 20 20 00
00 20 10 20 20 20 20 20 60 20 20 20 20 20 20 20 25 25 20 20 20 20 20 20 20 20 20 20 20 20 20 10 20 00
00 20 40 20 20 20 20 20 20 20 20 20 20 20 20 20 25 25 20 20 20 20 20 20 60 20 20 20 20 20 20 50 20 00
00 20 20 20 20 20 20 20 20 20 20 20 20 20 30 20 25 25 20 20 20 20 20 20 20 20 20 20 20 20 20 20 20 00
00 20 20 20 20 60 20 20 20 20 20 20 20 20 20 20 25 25 20 20 60 20 20 20 20 20 20 20 20 60 20 20 20 00
00 20 20 20 20 20 20 20 20 20 20 20 20 20 20 20 25 25 20 20 20 20 20 20 20 20 20 20 20 20 20 20 20 00
00 00 00 00 00 00 00 00 00 00 00 00 00 00 00 00 21 21 00 00 00 00 00 00 00 00 00 00 00 00 20 20 20 00
00 00 21 25 21 25 21 25 21 25 21 00 22 22 22 22 22 22 22 22 22 22 00 23 23 23 23 23 23 00 20 20 20 00
00 00 25 10 25 21 25 21 25 21 25 00 22 22 22 22 22 22 22 22 22 22 00 23 23 23 23 23 23 00 20 20 20 00
00 00 21 25 21 25 21 25 21 25 21 21 22 22 32 22 22 22 22 32 22 22 21 23 23 23 23 23 23 00 20 20 20 00
00 00 25 21 25 21 25 21 25 21 25 21 22 22 22 22 22 22 22 22 22 22 21 23 23 23 23 23 23 00 20 20 20 00
00 00 21 10 21 25 21 25 21 25 21 00 22 22 22 22 22 22 22 22 22 22 00 23 23 23 23 23 23 00 20 20 20 00
00 00 25 21 25 21 25 21 25 21 25 00 22 22 22 22 22 22 22 22 22 22 00 23 23 23 23 23 23 00 20 20 20 00
00 00 00 00 00 00 00 00 00 00 00 00 00 00 00 00 24 24 00 00 00 00 00 23 23 23 23 23 23 00 20 20 20 00
00 00 24 24 24 24 24 24 24 24 24 24 24 24 24 24 24 24 24 24 24 34 00 23 23 23 23 23 23 00 20 20 20 00
00 00 24 24 24 24 24 24 24 24 24 24 24 24 24 24 24 24 24 24 24 24 00 23 23 23 23 23 23 00 20 20 20 00
00 00 24 24 24 24 24 24 24 24 24 24 24 24 24 24 24 24 24 24 24 24 00 23 23 23 23 23 23 00 20 20 20 00
00 00 24 24 24 24 24 24 24 24 24 24 24 24 24 24 24 24 24 24 24 24 00 23 23 23 23 23 23 00 21 21 00 00
00 00 24 24 24 24 24 24 24 24 24 24 24 24 24 24 24 24 24 24 24 24 00 23 23 23 23 23 23 23 23 23 00 00
00 00 24 24 24 24 24 24 24 24 24 24 24 24 24 24 24 24 24 24 24 24 00 23 23 23 23 23 23 23 23 23 00 00
00 00 24 24 24 24 24 24 24 24 24 24 24 24 24 24 24 24 24 24 24 24 00 23 23 23 23 23 23 23 23 23 00 00
00 00 24 24 24 24 24 24 24 24 24 24 24 24 24 24 24 24 24 24 24 24 00 23 23 23 23 23 23 23 23 23 00 00
00 00 24 24 24 24 24 24 34 00 00 00 00 00 00 00 00 00 00 00 00 00 00 23 23 23 23 23 23 23 23 23 00 00
00 00 24 24 24 24 24 24 24 24 24 24 24 24 24 24 00 23 23 23 23 23 23 23 23 23 23 23 23 23 23 23 00 00
00 00 24 24 24 24 24 24 24 24 24 24 24 24 24 24 00 23 23 23 23 23 23 23 23 23 23 23 23 23 23 23 00 00
00 00 24 24 24 24 24 24 24 24 24 24 24 24 24 24 00 23 23 23 23 23 23 23 23 23 23 23 23 23 23 23 00 00
00 00 24 24 24 24 24 24 24 24 24 24 24 24 24 24 21 23 23 23 23 23 23 23 23 23 23 23 23 23 23 23 00 00
00 00 24 24 24 24 24 24 24 24 24 24 24 24 24 24 21 23 23 23 23 23 23 23 23 23 23 23 23 23 23 23 00 00
00 00 24 24 24 24 24 24 24 24 24 24 24 24 24 24 00 23 23 23 23 23 23 23 23 23 23 23 23 23 23 23 00 00
00 00 24 24 24 24 24 24 24 24 24 24 24 24 24 24 00 23 23 23 23 23 23 23 23 23 23 23 23 23 23 23 00 00
00 00 34 24 24 24 24 24 24 24 24 24 24 24 24 24 00 23 23 23 23 23 23 23 23 23 23 23 23 23 23 23 00 00
00 00 00 00 00 00 00 00 00 00 00 00 00 00 00 00 00 00 00 00 00 00 00 00 00 00 00 00 00 00 00 00 00 00
00 00 00 00 00 00 00 00 00 00 00 00 00 00 00 00 00 00 00 00 00 00 00 00 00 00 00 00 00 00 00 00 00 00 