00 00 00 00 00 00 00 00 00 00 00 00 00 00 00 00 00 00 00 00 00 00 00 00 00 00 00 00 00 00 00 00 00 00 00 00 00 00 00 00 00 00 00 00 00 00 00 00 00 00 00 00 00 00 00 00 00 00 00 00 00 00 00 00 00 00
00 20 20 20 20 20 20 20 20 20 20 20 20 20 20 20 20 20 20 20 20 20 20 20 20 20 20 20 20 20 20 20 20 20 20 20 20 20 20 20 20 20 20 20 20 20 20 20 20 20 20 20 20 20 20 20 20 20 20 20 20 20 20 20 20 00
00 20 10 10 10 10 10 10 10 10 10 10 10 10 10 10 10 10 10 10 10 10 10 10 10 10 10 10 10 10 10 10 10 10 10 10 10 10 10 10 10 10 10 10 10 10 10 10 10 10 10 10 10 10 10 10 10 10 10 10 10 10 10 10 20 00
00 20 10 20 20 20 20 20 20 20 20 20 20 20 20 20 20 20 20 20 20 20 20 20 20 20 20 20 20 20 20 20 20 20 20 20 20 20 20 20 20 20 20 20 20 20 20 20 20 20 20 20 20 20 20 20 20 20 20 20 20 20 20 10 20 00
00 20 10 20 30 30 30 30 30 30 30 30 30 30 30 30 30 30 30 30 30 30 30 30 30 30 30 30 30 30 30 30 30 30 30 30 30 30 30 30 30 30 30 30 30 30 30 30 30 30 30 30 30 30 30 30 30 30 30 30 30 30 20 10 20 00
00 20 10 20 30 20 30 20 20 20 20 20 20 20 20 20 20 20 20 20 20 20 20 20 20 20 20 20 20 20 20 20 30 30 20 20 20 20 20 20 20 20 20 20 20 20 20 20 20 20 20 20 20 20 20 20 20 20 20 30 20 30 20 10 20 00
00 20 10 20 30 30 20 20 20 20 20 20 20 20 20 20 20 20 20 20 20 20 20 20 20 20 20 20 20 20 20 20 30 30 20 20 20 20 20 20 20 20 20 20 20 20 20 20 20 20 20 20 20 20 20 20 20 20 20 20 30 30 20 10 20 00
00 20 10 20 30 20 20 20 20 20 20 20 20 20 20 20 20 20 20 20 26 20 20 20 20 20 20 20 20 20 20 20 30 30 20 20 20 20 20 20 20 20 20 20 26 20 20 20 20 20 20 20 20 20 20 20 20 20 20 20 20 30 20 10 20 00
00 20 10 20 30 20 20 20 20 20 20 20 20 20 20 20 20 20 20 20 20 20 20 20 20 20 20 20 20 20 20 20 30 30 20 20 20 20 20 20 20 20 20 20 20 20 20 20 20 20 20 20 20 20 20 20 20 20 20 20 20 30 20 10 20 00
00 20 10 20 30 20 20 20 20 20 20 20 26 20 20 20 20 20 20 20 20 20 20 20 20 20 20 20 20 20 20 20 30 30 20 20 20 20 20 20 20 20 20 20 20 20 20 20 20 20 20 20 20 26 20 20 20 20 20 20 20 30 20 10 20 00
00 20 10 20 30 30 30 30 30 30 30 30 30 30 30 30 20 20 20 20 20 20 20 20 20 20 20 20 20 20 26 20 30 30 20 26 20 20 20 20 20 20 20 20 20 20 20 20 20 20 30 30 30 30 30 30 30 30 30 30 30 30 20 10 20 00
00 20 10 20 30 20 20 20 20 20 20 20 20 20 20 30 20 20 20 20 20 20 20 20 20 20 20 20 20 20 20 20 30 30 20 20 20 20 20 20 20 20 20 20 20 20 20 20 20 20 30 20 20 20 20 20 20 20 20 20 20 30 20 10 20 00
00 20 10 20 30 20 20 20 20 20 20 20 20 20 20 30 20 20 20 20 20 20 20 20 20 20 20 20 20 20 20 20 30 30 20 20 20 20 20 20 20 20 20 20 20 20 20 20 20 20 30 20 20 20 20 20 20 20 20 20 20 30 20 10 20 00
00 20 10 20 30 20 20 20 20 20 20 20 20 20 20 30 20 20 20 20 20 20 20 20 20 20 20 20 20 20 20 20 30 30 20 20 20 20 20 20 20 20 20 20 20 20 20 20 20 20 30 20 20 20 20 20 20 20 20 20 20 30 20 10 20 00
00 20 10 20 30 20 20 20 20 20 20 20 20 20 20 30 20 20 20 20 20 20 20 20 20 20 20 20 20 20 20 20 30 30 20 20 20 20 20 20 20 20 20 20 20 20 20 20 20 20 30 20 20 20 20 20 20 20 20 20 20 30 20 10 20 00
00 20 10 20 31 21 21 21 21 31 20 20 20 20 20 30 20 20 20 20 20 20 20 20 20 20 20 20 20 20 20 20 30 30 20 20 20 20 20 20 20 20 20 20 20 20 20 20 20 20 30 20 20 20 20 20 31 21 21 21 21 31 20 10 20 00
00 20 10 20 21 20 20 20 20 21 20 20 20 20 20 30 20 20 20 20 26 20 20 20 20 20 20 20 20 20 20 30 30 30 30 20 20 20 20 20 20 20 20 20 20 20 20 20 20 20 30 20 20 20 20 20 21 20 20 20 20 21 20 10 20 00
00 20 10 20 21 20 20 20 20 21 20 20 20 20 20 30 30 20 20 20 20 20 20 20 20 20 20 20 20 20 30 20 20 20 20 30 20 20 20 20 20 20 20 20 20 20 20 20 20 30 30 20 20 20 20 20 21 20 20 20 20 21 20 10 20 00
00 20 10 20 21 20 20 20 20 21 20 20 20 20 20 30 20 30 20 20 20 20 20 20 20 20 20 20 20 30 20 20 20 26 20 20 30 20 20 20 20 20 20 20 20 20 20 20 30 20 30 20 20 20 20 20 21 20 20 20 20 21 20 10 20 00
00 20 10 20 21 41 51 20 20 21 20 20 27 20 20 30 20 30 20 20 20 20 20 20 20 20 20 26 20 30 20 20 30 30 20 20 30 20 20 26 20 20 20 20 20 20 20 20 30 20 30 20 20 26 20 20 21 20 20 41 51 21 20 10 20 00
00 20 10 20 21 42 52 20 20 21 20 20 26 20 20 30 20 30 20 20 20 20 20 20 20 20 20 20 20 30 20 20 30 22 20 20 30 20 20 20 20 20 20 20 20 20 20 20 30 20 30 20 20 27 20 20 21 20 20 42 52 21 20 10 20 00
00 20 10 20 21 20 20 20 20 21 20 20 20 20 20 30 20 30 20 20 20 20 20 20 20 20 20 20 20 30 20 20 20 26 20 20 30 20 20 20 20 20 20 20 20 20 20 20 30 20 30 20 20 20 20 20 21 20 20 20 20 21 20 10 20 00
00 20 10 20 21 20 20 20 20 21 20 20 20 20 20 30 30 20 20 20 20 20 20 20 20 20 20 20 20 20 30 20 20 20 20 30 20 20 20 20 20 20 20 20 20 20 20 20 20 30 30 20 20 20 20 20 21 20 20 20 20 21 20 10 20 00
00 20 10 20 21 20 20 20 20 21 20 20 20 20 20 30 20 20 20 20 26 20 20 20 20 20 20 20 20 20 20 30 30 30 30 20 20 20 20 20 20 20 20 20 20 20 20 20 20 20 30 20 20 20 20 20 21 20 20 20 20 21 20 10 20 00
00 20 10 20 31 21 21 21 21 31 20 20 20 20 20 30 20 20 20 20 20 20 20 20 20 20 20 20 20 20 20 20 30 30 20 20 20 20 20 20 20 20 20 20 20 20 20 20 20 20 30 20 20 20 20 20 31 21 21 21 21 31 20 10 20 00
00 20 10 20 30 20 20 20 20 20 20 20 20 20 20 30 20 20 20 20 20 20 20 20 20 20 20 20 20 20 20 20 30 30 20 20 20 20 20 20 20 20 20 20 20 20 20 20 20 20 30 20 20 20 20 20 20 20 20 20 20 30 20 10 20 00
00 20 10 20 30 20 20 20 20 20 20 20 20 20 20 30 20 20 20 20 20 20 20 20 20 20 20 20 20 20 20 20 30 30 20 20 20 20 20 20 20 20 20 20 20 20 20 20 20 20 30 20 20 20 20 20 20 20 20 20 20 30 20 10 20 00
00 20 10 20 30 20 20 20 20 20 20 20 20 20 20 30 20 20 20 20 20 20 20 20 20 20 20 20 20 20 20 20 30 30 20 20 20 20 20 20 20 20 20 20 20 20 20 20 20 20 30 20 20 20 20 20 20 20 20 20 20 30 20 10 20 00
00 20 10 20 30 20 20 20 20 20 20 20 20 20 20 30 20 20 20 20 20 20 20 20 20 20 20 20 20 20 20 20 30 30 20 20 20 20 20 20 20 20 20 20 20 20 20 20 20 20 30 20 20 20 20 20 20 20 20 20 20 30 20 10 20 00
00 20 10 20 30 30 30 30 30 30 30 30 30 30 30 30 20 20 20 20 20 20 20 20 20 20 20 20 20 20 26 20 30 30 20 26 20 20 20 20 20 20 20 20 20 20 20 20 20 20 30 30 30 30 30 30 30 30 30 30 30 30 20 10 20 00
00 20 10 20 30 20 20 20 20 20 20 20 26 20 20 20 20 20 20 20 20 20 20 20 20 20 20 20 20 20 20 20 30 30 20 20 20 20 20 20 20 20 20 20 20 20 20 20 20 20 20 20 20 26 20 20 20 20 20 20 20 30 20 10 20 00
00 20 10 20 30 20 20 20 20 20 20 20 20 20 20 20 20 20 20 20 20 20 20 20 20 20 20 20 20 20 20 20 30 30 20 20 20 20 20 20 20 20 20 20 20 20 20 20 20 20 20 20 20 20 20 20 20 20 20 20 20 30 20 10 20 00
00 20 10 20 30 20 20 20 20 20 20 20 20 20 20 20 20 20 20 20 26 20 20 20 20 20 20 20 20 20 20 20 30 30 20 20 20 20 20 20 20 20 20 20 20 26 20 20 20 20 20 20 20 20 20 20 20 20 20 20 20 30 20 10 20 00
00 20 10 20 30 30 20 20 20 20 20 20 20 20 20 20 20 20 20 20 20 20 20 20 20 20 20 20 20 20 20 20 30 30 20 20 20 20 20 20 20 20 20 20 20 20 20 20 20 20 20 20 20 20 20 20 20 20 20 20 30 30 20 10 20 00
00 20 10 20 30 20 30 20 20 20 20 20 20 20 20 20 20 20 20 20 20 20 20 20 20 20 20 20 20 20 20 20 30 30 20 20 20 20 20 20 20 20 20 20 20 20 20 20 20 20 20 20 20 20 20 20 20 20 20 30 20 30 20 10 20 00
00 20 10 20 30 30 30 30 30 30 30 30 30 30 30 30 30 30 30 30 30 30 30 30 30 30 30 30 30 30 30 30 30 30 30 30 30 30 30 30 30 30 30 30 30 30 30 30 30 30 30 30 30 30 30 30 30 30 30 30 30 30 20 10 20 00
00 20 10 20 20 20 20 20 20 20 20 20 20 20 20 20 20 20 20 20 20 20 20 20 20 20 20 20 20 20 20 20 20 20 20 20 20 20 20 20 20 20 20 20 20 20 20 20 20 20 20 20 20 20 20 20 20 20 20 20 20 20 20 10 20 00
00 20 10 10 10 10 10 10 10 10 10 10 10 10 10 10 10 10 10 10 10 10 10 10 10 10 10 10 10 10 10 10 10 10 10 10 10 10 10 10 10 10 10 10 10 10 10 10 10 10 10 10 10 10 10 10 10 10 10 10 10 10 10 10 20 00
00 20 20 20 20 20 20 20 20 20 20 20 20 20 20 20 20 20 20 20 20 20 20 20 20 20 20 20 20 20 20 20 20 20 20 20 20 20 20 20 20 20 20 20 20 20 20 20 20 20 20 20 20 20 20 20 20 20 20 20 20 20 20 20 20 00
00 00 00 00 00 00 00 00 00 00 00 00 00 00 00 00 00 00 00 00 00 00 00 00 00 00 00 00 00 00 00 00 00 00 00 00 00 00 00 00 00 00 00 00 00 00 00 00 00 00 00 00 00 00 00 00 00 00 00 00 00 00 00 00 00 00 