00 00 00 00 00 00 00 00 00 00 00 00 00 00 00 00 00 00 00 00 00 00 00 00 00 00 00 00 00 00 00 00 00 00
00 20 20 20 20 20 20 25 25 25 20 20 20 20 20 20 20 20 20 20 20 20 20 20 25 25 25 20 20 20 20 20 20 00
00 20 20 20 20 20 20 25 25 25 20 20 20 20 20 20 20 20 20 20 20 20 20 20 25 25 25 20 20 20 20 20 20 00
00 20 20 20 20 60 20 25 25 25 20 20 20 20 20 20 20 20 20 20 20 20 20 20 25 25 25 20 20 20 60 20 20 00
00 20 20 20 20 20 20 25 25 25 30 50 20 50 20 50 30 30 50 20 50 20 50 30 25 25 25 20 20 20 20 20 20 00
00 20 20 20 20 20 20 25 25 25 20 10 20 10 20 10 20 20 10 20 10 20 10 20 25 25 25 20 20 20 20 20 20 00
00 20 20 20 20 20 20 25 25 25 20 20 20 20 20 20 20 20 20 20 20 20 20 20 25 25 25 20 20 20 20 20 20 00
00 25 25 25 25 25 25 25 25 25 25 25 25 25 25 25 25 25 25 25 25 25 25 25 25 25 25 25 25 25 25 25 25 00
00 25 25 25 25 25 25 25 25 25 25 25 25 25 25 25 25 25 25 25 25 25 25 25 25 25 25 25 25 25 25 25 25 00
00 20 20 20 20 20 20 25 25 25 20 20 30 20 20 20 20 20 20 20 20 30 20 20 25 25 25 20 20 20 20 20 20 00
00 20 20 20 50 10 20 25 25 25 20 10 40 20 20 20 20 20 20 20 20 40 10 20 25 25 25 20 10 50 20 20 20 00
00 20 20 20 20 20 20 25 25 25 20 20 20 20 20 20 20 20 20 20 20 20 20 20 25 25 25 20 20 20 20 20 20 00
00 20 20 20 50 10 20 25 25 25 20 10 40 20 20 60 20 20 20 20 20 40 10 20 25 25 25 20 10 50 20 20 20 00
00 20 20 20 20 20 20 25 25 25 20 20 20 20 20 20 20 20 20 20 20 20 20 20 25 25 25 20 20 20 20 20 20 00
00 20 20 20 50 10 20 25 25 25 20 10 40 20 20 20 20 20 20 20 20 40 10 20 25 25 25 20 10 50 20 20 20 00
00 20 20 20 20 20 20 25 25 25 20 20 20 20 20 20 31 31 20 20 20 20 20 20 25 25 25 20 20 20 20 20 20 00
00 20 20 20 50 10 20 25 25 25 20 10 40 20 20 31 41 51 31 20 20 40 10 20 25 25 25 20 10 50 20 20 20 00
00 20 20 20 50 10 20 25 25 25 20 10 40 20 20 31 42 52 31 20 20 40 10 20 25 25 25 20 10 50 20 20 20 00
00 20 20 20 20 20 20 25 25 25 20 20 20 20 20 20 31 31 20 20 20 20 20 20 25 25 25 20 20 20 20 20 20 00
00 20 20 20 50 10 20 25 25 25 20 10 40 20 20 20 20 20 20 20 20 40 10 20 25 25 25 20 10 50 20 20 20 00
00 20 20 20 20 20 20 25 25 25 20 20 20 20 20 20 20 20 20 20 20 20 20 20 25 25 25 20 20 20 20 20 20 00
00 20 20 20 50 10 20 25 25 25 20 10 40 20 20 20 20 20 20 20 20 40 10 20 25 25 25 20 10 50 20 20 20 00
00 20 20 20 20 20 20 25 25 25 20 20 20 20 20 20 20 20 20 20 20 20 20 20 25 25 25 20 20 20 20 20 20 00
00 20 20 20 50 10 20 25 25 25 20 10 40 20 20 20 20 60 20 20 20 40 10 20 25 25 25 20 10 50 20 20 20 00
00 20 20 20 20 20 20 25 25 25 20 20 30 20 20 20 20 20 20 20 20 30 20 20 25 25 25 20 20 20 20 20 20 00
00 25 25 25 25 25 25 25 25 25 25 25 25 25 25 25 25 25 25 25 25 25 25 25 25 25 25 25 25 25 25 25 25 00
00 25 25 25 25 25 25 25 25 25 25 25 25 25 25 25 25 25 25 25 25 25 25 25 25 25 25 25 25 25 25 25 25 00
00 20 20 20 20 20 60 25 25 25 20 20 20 20 20 20 20 20 20 20 20 20 20 20 25 25 25 20 20 20 20 20 20 00
00 20 20 20 20 20 20 25 25 25 20 10 20 10 20 10 20 20 10 20 10 20 10 20 25 25 25 20 20 20 20 20 20 00
00 20 20 20 20 20 20 25 25 25 30 50 20 50 20 50 30 30 50 20 50 20 50 30 25 25 25 20 20 20 20 20 20 00
00 20 20 20 20 20 20 25 25 25 20 20 20 20 20 20 20 20 20 20 20 20 20 20 25 25 25 20 20 20 60 20 20 00
00 20 20 20 20 20 20 25 25 25 20 20 20 20 20 20 20 20 20 20 20 20 20 20 25 25 25 20 20 20 20 20 20 00
00 20 20 20 20 20 20 25 25 25 20 20 20 20 20 20 20 20 20 20 20 20 20 20 25 25 25 20 20 20 20 20 20 00
00 00 00 00 00 00 00 00 00 00 00 00 00 00 00 00 00 00 00 00 00 00 00 00 00 00 00 00 00 00 00 00 00 00 