00 00 00 00 00 00 00 00 00 00 00 00 00 00 00 00 00 00 00 00 00 00 00 00 00 00 00 00 00 00 00 00 00 00
00 23 23 23 23 23 23 23 23 23 23 23 23 23 23 23 23 00 20 20 20 20 20 20 20 22 22 20 20 20 20 20 20 00
00 23 23 23 23 23 23 23 23 23 23 23 23 23 23 23 23 00 20 10 10 10 10 10 20 22 22 20 10 10 10 10 20 00
00 23 23 23 23 23 23 23 23 23 23 23 23 23 23 23 23 00 20 20 20 20 20 60 20 22 22 20 20 20 20 10 20 00
00 23 23 23 23 23 23 23 23 23 23 23 23 23 23 23 23 00 20 20 20 20 20 20 20 22 22 20 20 20 20 10 20 00
00 23 23 23 23 23 23 23 23 23 23 23 23 23 23 23 23 00 20 20 20 20 20 20 20 22 22 20 20 20 20 10 20 00
00 23 23 23 23 23 23 23 23 23 23 33 23 23 33 23 23 00 20 20 20 20 20 20 20 22 22 20 20 20 20 20 20 00
00 23 23 23 23 23 00 00 00 00 00 00 23 23 00 00 00 00 20 20 20 20 20 20 20 22 22 20 20 60 20 20 20 00
00 23 23 23 23 23 00 20 20 20 20 20 22 22 20 20 20 20 20 20 20 20 20 20 20 22 22 20 20 20 20 20 20 00
00 23 23 23 23 23 00 20 20 20 20 20 22 22 20 20 20 20 20 20 20 20 20 20 20 22 22 20 20 20 20 20 20 00
00 23 23 23 23 23 00 20 20 20 20 20 22 22 20 20 20 20 20 20 20 20 20 20 20 22 22 20 20 20 20 20 20 00
00 23 23 23 33 23 00 20 20 20 20 20 22 22 20 20 20 20 20 20 20 20 20 20 20 22 22 20 20 20 20 20 20 00
00 00 23 23 00 00 00 20 20 20 20 20 22 22 20 20 60 20 20 20 20 20 20 20 20 22 22 20 20 20 20 20 20 00
00 20 22 22 20 20 20 20 20 20 60 20 22 22 20 20 20 20 20 20 20 20 20 20 20 22 22 20 20 20 20 20 20 00
00 20 22 22 20 20 20 20 20 20 20 20 22 22 20 20 20 20 20 20 20 20 20 20 20 22 22 20 20 20 20 20 20 00
00 20 22 22 20 20 20 20 20 20 20 32 22 22 32 20 20 20 20 20 20 20 20 20 32 22 22 32 20 20 20 20 20 00
00 20 22 22 22 22 22 22 22 22 22 22 60 20 22 22 22 22 22 22 22 22 22 22 22 20 20 22 22 22 22 22 22 00
00 20 32 22 22 22 22 22 22 22 22 22 20 20 22 22 22 22 22 22 22 22 22 22 22 20 60 22 22 22 22 22 22 00
00 20 20 20 20 20 20 20 20 20 20 32 22 22 32 20 20 20 22 22 20 20 20 20 32 22 22 32 20 20 20 20 20 00
00 20 20 20 20 20 20 20 20 20 20 20 22 22 20 20 20 60 22 22 20 60 20 20 20 22 22 20 20 20 20 20 20 00
00 20 20 40 20 50 20 20 40 20 20 20 22 22 20 00 00 00 22 22 00 00 00 00 20 22 22 20 50 20 40 20 20 00
00 20 20 20 20 20 20 20 20 20 20 20 22 22 20 00 21 31 21 21 31 21 21 00 20 22 22 20 20 20 20 20 20 00
00 20 20 20 20 20 20 20 20 20 20 20 22 22 20 00 21 61 21 21 21 21 61 00 20 22 22 20 20 20 20 20 20 00
00 20 10 50 20 40 20 50 20 40 20 20 22 22 20 00 21 21 21 41 51 21 21 00 20 22 22 20 40 20 20 50 20 00
00 20 10 20 20 20 20 20 20 20 20 20 22 22 20 00 21 21 21 42 52 21 21 00 20 22 22 20 20 20 20 20 20 00
00 20 10 10 20 20 20 20 20 20 20 20 22 22 20 00 61 21 21 21 21 21 61 00 20 22 22 20 10 10 10 10 20 00
00 20 20 20 20 20 20 20 20 20 20 20 22 22 20 00 00 00 00 00 00 00 00 00 20 22 22 20 20 20 20 20 20 00
00 00 00 00 00 00 00 00 00 00 00 00 00 00 00 00 00 00 00 00 00 00 00 00 00 00 00 00 00 00 00 00 00 00 