00 00 00 00 00 00 00 00 00 00 00 00 00 00 00 00 00 00 00 00 00 00 00 00 00 00 00 00 00 00 00 00 00 00
00 20 20 20 20 20 20 20 20 20 20 20 20 22 22 22 22 20 20 20 20 20 20 20 20 20 20 20 20 20 20 20 20 00
00 20 20 20 20 20 20 20 20 20 20 22 32 22 22 22 22 32 22 20 20 20 20 20 20 20 20 20 20 20 20 20 20 00
00 20 60 50 50 20 20 20 60 20 20 22 22 22 22 22 22 22 22 20 50 20 20 20 20 20 60 60 20 20 20 60 20 00
00 20 20 20 20 00 00 00 00 00 00 00 00 24 00 00 24 00 00 00 00 00 00 00 00 20 20 20 20 20 20 20 20 00
00 20 20 60 20 00 34 24 24 24 24 00 23 23 23 23 23 23 00 24 24 24 24 34 00 20 20 20 20 20 20 60 20 00
00 20 20 20 30 00 24 24 24 24 24 23 23 23 23 23 23 23 23 24 24 24 24 24 00 30 20 40 40 50 20 20 20 00
00 20 10 20 20 24 24 24 24 24 24 23 23 23 23 23 23 23 23 24 24 24 24 24 24 20 20 10 10 10 20 20 20 00
00 20 20 20 30 00 24 24 24 24 24 00 23 23 23 23 23 23 00 24 24 24 24 24 00 30 20 50 50 40 50 20 20 00
00 20 20 20 20 00 24 24 24 24 24 00 23 23 23 23 23 23 00 24 24 24 24 24 00 20 20 10 10 10 10 20 20 00
00 20 50 20 20 00 24 24 24 24 24 00 23 23 23 23 23 23 00 24 24 24 24 24 00 20 20 50 20 40 40 20 20 00
00 20 20 20 20 00 31 24 24 24 24 00 23 33 21 21 33 23 00 34 24 24 24 24 00 20 20 10 20 10 10 20 20 00
00 20 50 20 20 00 31 24 24 24 24 00 00 00 23 23 00 00 00 24 24 24 24 24 00 60 20 40 50 40 50 20 20 00
00 60 60 20 20 00 24 24 24 24 24 00 22 22 22 22 22 22 00 24 24 24 24 24 00 20 20 10 10 10 10 20 20 00
00 20 20 20 20 00 24 24 24 24 34 00 22 32 22 22 32 22 00 24 24 24 24 34 00 20 20 20 20 20 20 20 60 00
00 20 20 20 20 00 00 24 00 00 00 00 22 22 22 22 22 22 00 00 00 00 24 00 00 20 20 20 20 20 30 20 20 00
00 10 20 20 20 20 30 20 30 22 22 22 22 22 22 22 22 22 22 22 22 30 20 30 20 20 20 20 25 20 20 20 20 00
00 20 20 20 20 20 20 20 20 20 22 22 22 32 22 22 32 22 22 22 20 20 20 25 20 20 20 20 20 20 27 20 20 00
00 20 60 20 20 20 20 20 20 20 20 20 22 22 22 22 22 22 20 20 20 20 25 25 25 25 20 25 20 20 25 20 20 00
00 20 20 20 20 20 20 10 20 20 20 20 20 20 20 20 20 20 20 20 20 25 25 25 25 25 25 25 26 25 20 20 20 00
00 20 20 50 10 20 20 20 20 60 20 20 20 20 20 20 20 20 20 20 25 25 00 00 00 00 00 00 00 00 20 20 27 00
00 20 20 20 20 20 20 20 20 20 20 20 20 20 20 20 20 20 20 25 25 26 00 31 21 21 21 21 31 25 25 20 20 00
00 50 20 20 60 20 20 20 20 20 20 20 20 60 20 20 20 20 20 25 25 25 00 21 21 61 21 21 00 00 20 20 20 00
00 20 20 20 20 20 50 60 20 20 20 50 20 20 20 20 20 20 20 20 25 25 25 21 21 41 51 21 21 00 20 20 20 00
00 20 20 20 20 20 20 20 20 10 20 20 20 20 20 20 20 20 25 20 25 27 00 61 21 42 52 21 00 25 25 25 20 00
00 20 10 60 20 20 10 20 20 20 20 20 60 20 20 20 20 20 20 20 25 27 00 21 21 21 21 61 21 25 20 20 20 00
00 20 20 20 20 20 20 50 20 60 20 60 20 20 20 20 20 20 25 20 25 25 00 31 21 21 21 21 31 00 20 25 20 00
00 20 20 10 20 20 20 20 20 20 20 20 20 20 20 20 20 20 20 20 20 25 00 00 25 00 25 00 00 25 27 20 20 00
00 20 20 20 50 20 20 20 20 20 10 20 20 10 20 20 20 20 20 20 25 20 20 20 25 20 20 25 20 20 20 20 20 00
00 20 20 20 20 10 20 20 20 20 20 20 20 20 20 20 20 20 20 20 20 10 10 10 10 10 10 10 10 10 10 10 20 00
00 20 20 20 20 20 20 20 20 20 20 20 20 20 20 20 20 20 20 20 20 10 10 10 10 10 10 10 10 10 10 10 20 00
00 20 20 20 20 20 20 20 20 20 20 20 20 20 20 20 20 20 20 20 20 10 10 10 10 10 10 10 10 10 10 10 20 00
00 20 20 20 20 20 20 20 20 20 20 20 20 20 20 20 20 20 20 20 20 20 20 20 20 20 20 20 20 20 20 20 20 00
00 00 00 00 00 00 00 00 00 00 00 00 00 00 00 00 00 00 00 00 00 00 00 00 00 00 00 00 00 00 00 00 00 00 