00 00 00 00 00 00 00 00 00 00 00 00 00 00 00 00 
00 25 10 10 10 10 25 00 00 25 10 10 10 10 25 00 
00 25 25 25 25 25 25 25 25 25 25 25 25 25 25 00 
00 25 25 00 25 25 25 25 25 25 25 25 00 25 25 00 
00 27 27 00 25 25 35 21 21 35 25 25 00 25 25 00 
00 25 26 25 25 25 21 41 51 21 25 25 25 25 25 00 
00 27 25 25 25 25 21 42 52 21 25 25 25 25 25 00 
00 25 25 00 25 25 35 21 21 35 25 25 00 25 25 00 
00 25 25 00 25 25 25 25 25 25 25 25 00 25 25 00 
00 25 25 25 25 25 25 25 25 25 25 25 25 25 25 00 
00 25 25 25 25 25 25 25 25 25 25 25 26 25 25 00 
00 00 25 35 10 10 25 00 00 25 10 10 10 10 25 00 
00 00 25 25 25 25 25 00 00 25 25 25 25 25 25 00 
00 00 00 27 25 00 00 00 00 00 00 00 00 00 25 00
00 00 00 25 25 25 25 25 25 25 25 25 25 25 25 00 
00 00 25 25 25 25 25 25 25 25 25 10 10 10 25 00 
00 25 10 25 25 25 35 25 25 25 25 10 10 10 25 00 
00 27 25 25 25 25 25 25 25 25 25 25 25 25 25 00 
00 00 00 00 00 00 00 00 25 25 00 00 00 00 00 00 
00 26 25 25 25 00 00 00 21 21 00 00 00 00 00 00 
00 25 10 10 26 25 20 20 21 21 30 20 20 25 25 00 
00 20 10 10 25 20 20 20 21 21 20 20 20 25 10 00 
00 20 10 10 25 25 20 20 21 21 20 25 25 25 26 00 
00 25 10 20 20 20 20 30 21 21 20 20 25 25 10 00 
00 20 25 25 20 25 20 21 21 21 20 25 25 25 25 00 
00 20 20 25 20 20 21 21 21 35 20 20 20 25 20 00 
00 20 25 25 20 21 21 21 25 25 25 20 20 25 20 00 
00 20 20 20 21 21 21 25 27 25 25 26 20 20 20 00 
00 20 30 21 21 21 10 20 00 00 25 25 00 00 20 00 
00 20 21 21 21 20 20 20 00 24 24 24 24 00 25 00 
00 25 21 21 20 20 00 00 00 24 24 24 24 00 20 00 
00 10 21 21 20 00 00 00 24 24 24 24 24 00 25 00 
00 10 21 21 20 00 24 00 24 24 24 34 24 00 20 00 
00 35 21 21 20 00 00 24 24 24 24 24 24 00 20 00 
00 25 21 21 20 20 00 00 00 00 00 00 25 00 20 00
00 20 21 21 21 20 20 20 20 20 20 25 20 25 20 00 
00 00 20 21 21 30 20 27 25 25 20 10 10 25 25 00 
00 00 00 21 21 21 20 20 25 20 20 10 10 10 25 00 
00 00 25 20 21 21 20 25 25 25 20 20 10 10 25 00 
00 25 20 20 21 21 20 25 25 25 25 27 20 25 25 00 
00 20 25 20 21 21 20 20 25 20 25 25 20 25 10 00 
00 26 25 20 21 21 20 25 25 25 20 25 25 25 10 00 
00 25 20 20 21 21 20 20 20 25 25 25 25 25 25 00 
00 10 25 20 21 21 21 20 20 20 20 25 20 25 00 00 
00 10 27 20 20 21 21 21 20 20 20 20 26 25 00 00 
00 25 25 20 25 20 21 21 21 20 25 20 20 20 00 00 
00 25 10 25 20 20 20 21 21 30 20 20 20 20 25 00 
00 27 10 25 20 25 20 21 21 21 21 21 41 51 20 00 
00 25 25 20 25 20 30 21 21 20 20 20 42 52 20 00 
00 25 20 20 20 20 20 21 21 20 20 20 20 20 20 00 
00 20 20 20 22 22 22 22 22 22 22 22 22 20 20 00 
00 22 22 22 22 22 00 25 25 00 00 22 22 22 22 00 
00 22 20 00 20 00 00 21 21 27 00 20 00 20 22 00 
00 22 00 00 00 00 00 25 25 25 00 00 00 00 22 00 
00 22 00 24 24 24 00 23 23 23 23 23 23 00 22 00 
00 22 00 24 24 24 00 23 23 23 23 23 23 00 22 00 
00 22 00 24 24 24 34 23 23 23 23 23 33 00 22 00 
00 22 00 24 24 24 24 23 23 23 23 23 23 25 22 00
00 22 00 24 24 24 00 23 23 23 23 23 23 00 22 00 
00 22 00 24 24 24 24 21 21 23 23 23 23 00 22 00
00 22 00 00 00 00 00 25 25 00 00 00 00 00 22 00 
00 25 10 10 10 10 10 10 10 10 10 10 10 10 25 00 
00 25 25 20 20 25 20 25 20 20 25 25 25 20 25 00 
00 00 00 00 00 00 00 00 00 00 00 00 00 00 00 00 
