00 00 00 00 00 00 00 00 00 00 00 00 00 00 00 00 00 00 00 00 00 00 00 00 00 00 00 00 00 00 00 00 00 00 00 00 00 00 00 00 00 00 00 00 00 00 00 00 00 00 00 00 00 00 00 00 00 00 00 00 00 00 00 00
00 25 25 25 25 25 25 25 25 25 25 25 25 25 25 25 25 25 25 25 25 25 25 25 25 25 25 25 25 25 25 25 25 25 25 25 25 25 25 25 25 25 25 25 25 25 25 25 25 25 25 25 25 25 25 25 25 25 25 25 25 25 25 00
00 25 10 10 10 10 10 10 10 10 10 10 10 10 10 10 10 10 10 10 10 10 10 10 10 10 10 10 10 10 10 10 10 10 10 10 10 10 10 10 10 10 10 10 10 10 10 10 10 10 10 10 10 10 10 10 10 10 10 10 10 10 25 00
00 25 10 25 25 25 25 25 25 25 25 25 25 25 25 25 25 25 25 25 25 25 25 25 25 25 25 25 25 25 25 25 25 25 25 25 25 25 25 25 25 25 25 25 25 25 25 25 25 25 25 25 25 25 25 25 25 25 25 25 25 10 25 00
00 25 10 25 25 25 25 25 25 25 25 25 25 25 25 25 25 25 25 25 25 25 25 25 25 25 25 25 25 25 25 25 25 25 25 25 25 25 25 25 25 25 25 25 25 25 25 25 25 25 25 25 25 25 25 25 25 25 25 25 25 10 25 00
00 25 10 25 25 25 25 25 25 25 25 25 25 25 25 25 25 25 25 25 25 25 25 25 25 25 25 25 25 25 25 25 25 25 25 25 25 25 25 25 25 25 25 25 25 25 25 25 25 25 25 25 25 25 25 25 25 25 25 25 25 10 25 00
00 25 10 25 25 25 33 25 25 25 25 25 25 25 25 25 25 25 25 25 25 25 25 25 25 25 33 25 25 25 25 25 25 25 25 25 25 25 25 25 25 25 25 33 25 25 25 25 25 25 25 25 25 25 25 25 25 33 25 25 25 10 25 00
00 25 10 25 25 25 25 00 00 25 25 25 25 00 00 00 25 25 00 00 00 25 25 25 25 00 00 25 25 25 25 00 00 25 25 25 25 00 00 25 25 25 25 00 00 25 25 25 25 00 00 00 25 25 25 00 00 25 25 25 25 10 25 00
00 25 10 25 25 25 25 00 00 25 25 25 25 00 00 25 25 25 25 00 00 25 25 25 25 00 00 25 25 25 25 00 00 25 25 25 25 00 00 25 25 25 25 00 00 25 25 25 25 00 00 25 25 25 25 00 00 25 25 25 25 10 25 00
00 25 10 25 25 25 25 25 25 25 25 25 25 00 25 25 25 25 25 25 00 25 25 25 25 25 25 25 25 25 25 00 25 25 25 25 25 25 00 25 25 25 25 25 25 25 25 25 25 25 25 25 25 25 25 25 25 25 25 25 25 10 25 00
00 25 10 25 25 25 25 25 25 25 25 25 25 25 25 25 25 25 25 25 25 25 25 25 25 25 25 25 25 25 25 00 25 25 25 25 25 25 00 25 25 25 25 25 25 25 25 25 25 25 25 25 25 25 25 25 25 25 25 25 25 10 25 00
00 25 10 25 25 25 25 25 25 25 25 25 25 25 25 25 25 25 25 25 25 25 25 25 25 25 25 25 25 25 25 00 25 25 25 25 25 25 00 25 25 25 25 25 25 25 25 25 25 25 25 25 25 25 25 25 25 25 25 25 25 10 25 00
00 25 10 25 25 25 25 25 25 25 25 25 25 00 25 25 25 25 25 25 00 25 25 25 25 25 25 25 25 25 25 00 25 25 25 25 25 25 00 25 25 25 25 25 25 25 25 25 25 25 25 25 25 25 25 25 25 25 25 25 25 10 25 00
00 25 10 25 25 25 25 00 00 25 25 25 25 00 00 25 25 25 25 00 00 25 25 25 25 00 00 25 25 25 25 00 00 25 25 25 25 00 00 25 25 25 25 00 00 25 25 25 25 00 00 00 25 25 00 00 00 25 25 25 25 10 25 00
00 25 10 25 25 25 25 00 00 25 25 25 25 00 00 00 25 25 00 00 00 25 25 25 25 00 00 25 25 25 25 00 00 25 25 25 25 00 00 25 25 25 25 00 00 25 25 25 25 00 00 25 25 25 25 00 00 25 25 25 25 10 25 00
00 25 10 25 25 25 25 25 25 25 25 25 25 25 25 25 25 25 25 25 25 25 25 25 25 25 25 25 25 25 25 25 25 25 25 25 25 25 25 25 25 25 25 25 25 25 25 25 25 00 25 25 25 25 25 25 00 25 25 25 25 10 25 00
00 25 10 25 25 25 25 25 25 25 25 25 25 25 25 25 25 25 25 25 25 25 25 25 25 25 25 25 25 25 25 25 25 25 25 25 25 25 25 25 25 25 25 25 25 25 25 25 25 25 25 25 25 25 25 25 25 25 25 25 25 25 25 00
00 25 10 25 25 25 25 25 25 25 25 25 25 25 25 25 25 25 25 25 25 25 25 25 25 25 25 25 25 25 25 25 25 25 25 25 25 25 25 25 25 25 25 25 25 25 25 25 25 25 25 25 25 25 25 25 25 25 25 25 00 00 00 00
00 25 10 25 25 25 25 25 25 25 25 25 25 25 25 25 25 25 25 25 25 25 25 25 25 25 25 25 25 25 25 25 25 25 25 25 25 25 25 25 25 25 25 25 25 25 25 25 25 00 25 25 25 25 25 25 00 25 25 00 00 00 00 00
00 25 10 25 25 25 25 00 00 25 25 25 25 00 00 25 25 25 25 00 00 25 25 25 25 00 00 25 25 25 25 00 00 25 25 25 25 00 00 25 25 25 25 00 00 25 25 25 25 00 00 25 25 25 25 00 00 25 25 25 25 00 00 00
00 25 10 25 25 25 25 00 00 25 25 25 25 00 00 25 25 25 25 00 00 25 25 25 25 00 00 25 25 25 25 00 00 25 25 25 25 00 00 25 25 25 25 00 00 25 25 25 25 00 00 00 25 25 00 00 00 25 25 25 25 25 25 00
00 25 10 25 25 25 25 25 25 25 25 25 25 25 25 25 25 25 25 25 25 25 25 25 25 25 25 25 25 25 25 00 21 21 21 21 21 21 00 25 25 25 25 25 25 25 25 25 25 25 25 25 25 25 25 25 25 25 25 25 25 10 25 00
00 25 10 25 25 25 25 25 25 25 25 25 25 25 25 25 25 25 25 25 25 25 25 25 25 25 25 25 25 25 25 00 21 21 21 21 21 21 00 25 25 25 25 25 25 25 25 25 25 25 25 25 25 25 25 25 25 25 25 25 25 10 25 00
00 25 10 25 25 25 25 25 25 25 25 25 25 25 25 25 25 25 25 25 25 25 25 25 25 25 25 25 25 25 25 00 21 21 21 21 21 21 00 25 25 25 25 25 25 25 25 25 25 25 25 25 25 25 25 25 25 25 25 25 25 10 25 00
00 25 10 25 25 25 25 25 25 25 25 25 25 25 25 25 25 25 25 25 25 25 25 25 25 25 25 25 25 25 25 25 21 21 21 33 21 21 25 25 25 25 25 25 25 25 25 25 25 25 25 25 25 25 25 25 25 25 25 25 25 10 25 00
00 25 10 25 25 25 25 00 00 25 25 25 25 00 00 00 00 00 00 00 00 25 25 25 25 00 00 25 25 25 25 25 21 21 00 00 21 21 25 25 25 25 25 00 00 25 25 25 25 00 00 25 25 25 25 00 00 25 25 25 25 10 25 00
00 25 10 25 25 25 25 00 00 25 25 25 25 00 00 25 25 25 25 00 00 25 25 25 25 00 00 00 00 00 00 00 21 21 00 00 21 21 00 00 00 00 00 00 00 25 25 25 25 00 00 25 25 25 25 00 00 33 25 25 25 10 25 00
00 25 10 25 25 25 25 25 25 25 25 25 25 25 25 25 25 25 25 25 25 25 25 25 25 25 00 21 21 21 21 21 21 21 21 21 21 21 21 21 21 21 21 00 25 25 25 25 25 25 25 25 25 25 25 25 25 25 25 25 25 10 25 00
00 25 10 25 25 25 25 25 25 25 25 25 25 25 25 25 25 25 25 25 25 25 25 25 25 25 00 21 21 21 21 21 21 21 21 21 21 21 21 21 21 21 21 00 25 25 25 25 25 25 25 25 25 25 25 25 25 25 25 25 25 10 25 00
00 25 10 25 25 25 25 25 25 25 25 25 25 25 25 25 25 25 25 25 25 25 25 25 25 25 00 21 21 21 21 21 21 21 21 21 21 21 21 21 21 21 21 00 25 25 25 25 25 25 25 25 25 25 25 25 25 25 25 25 25 10 25 00
00 25 10 25 25 25 25 25 25 25 25 25 25 25 25 25 25 25 25 25 25 25 25 25 25 25 00 21 21 21 21 21 33 21 21 21 21 21 33 21 21 21 21 00 25 25 25 25 25 25 25 25 25 25 25 25 25 25 25 25 25 10 25 00
00 25 10 25 25 25 25 00 00 25 25 25 25 00 00 25 25 25 25 00 00 25 25 25 25 25 00 21 21 21 21 00 00 21 21 21 21 00 00 21 21 21 21 00 25 25 25 25 25 00 00 00 00 00 00 00 00 25 25 25 25 10 25 00
00 25 10 25 25 25 25 00 00 25 25 25 25 00 00 25 25 25 25 00 00 25 25 21 21 21 21 21 21 21 33 00 00 21 21 21 21 00 00 33 21 21 21 21 21 21 21 25 25 00 00 25 25 25 25 00 00 25 25 25 25 10 25 00
00 25 10 25 25 25 25 25 25 25 25 25 25 25 25 25 25 25 25 25 25 21 21 21 21 21 21 21 21 21 21 21 21 21 21 21 21 21 21 21 21 21 21 21 21 21 21 21 21 25 25 25 25 25 25 25 25 25 25 25 25 10 25 00
00 25 10 25 25 25 25 25 25 25 25 25 25 25 25 25 25 25 25 25 25 21 21 21 21 21 00 21 21 21 21 21 21 21 21 21 21 21 21 21 21 21 21 00 21 21 21 21 21 25 25 25 25 25 25 25 25 25 25 25 25 10 25 00
00 25 10 25 25 25 25 25 25 25 25 25 25 25 25 25 25 25 25 25 25 21 21 21 21 21 00 33 21 21 21 21 21 21 21 21 21 21 21 21 21 21 33 00 21 21 21 21 21 25 25 25 25 25 25 25 25 25 25 25 25 10 25 00
00 25 10 25 25 25 25 25 25 25 25 25 25 25 25 25 25 25 25 25 25 21 21 21 21 21 21 21 21 21 21 21 21 21 21 21 21 21 21 21 21 21 21 21 21 21 21 21 21 25 25 25 25 25 25 25 25 25 25 25 25 10 25 00
00 25 10 25 25 25 25 00 00 00 25 25 00 00 00 25 25 25 25 00 00 25 25 21 21 21 21 21 21 21 33 00 00 21 21 21 21 00 00 33 21 21 21 21 21 21 21 25 25 00 00 25 25 25 25 00 00 25 25 25 25 10 25 00
00 25 10 25 25 25 25 00 00 25 25 25 25 00 00 25 25 25 25 00 00 25 25 25 25 25 00 21 21 21 21 00 00 21 21 21 21 00 00 21 21 21 21 00 25 25 25 25 25 00 00 00 00 00 00 00 00 25 25 25 25 10 25 00
00 25 10 25 25 25 25 00 25 25 25 25 25 25 00 25 25 25 25 25 25 25 25 25 25 25 00 21 21 21 21 21 33 21 21 21 21 33 21 21 21 21 21 00 25 25 25 25 25 25 25 25 25 25 25 25 25 25 25 25 25 10 25 00
00 25 10 25 25 25 25 25 25 25 25 25 25 25 25 25 25 25 25 25 25 25 25 25 25 25 00 21 21 21 21 21 21 21 21 21 21 21 21 21 21 21 21 00 25 25 25 25 25 25 25 25 25 25 25 25 25 25 25 25 25 10 25 00
00 25 10 25 25 25 25 25 25 25 25 25 25 25 25 25 25 25 25 25 25 25 25 25 25 25 00 21 21 21 21 21 21 21 21 21 21 21 21 21 21 21 21 00 25 25 25 25 25 25 25 25 25 25 25 25 25 25 25 25 25 10 25 00
00 25 10 25 25 25 25 00 25 25 25 25 25 25 00 25 25 25 25 25 25 25 25 25 25 25 00 21 21 21 21 21 21 21 21 33 21 21 21 21 21 21 21 00 25 25 25 25 25 25 25 25 25 25 25 25 25 25 25 25 25 10 25 00
00 25 10 25 25 25 25 00 00 25 25 25 25 00 00 25 25 25 25 00 00 25 25 25 25 00 00 00 00 00 00 00 21 21 00 00 21 21 00 00 00 00 00 00 00 25 25 25 25 00 00 25 25 25 25 00 00 25 25 25 25 10 25 00
00 25 10 25 25 25 25 00 00 00 25 25 00 00 00 25 25 25 25 00 00 25 25 25 25 00 00 25 25 25 25 25 21 21 00 00 21 21 25 25 25 25 25 00 00 25 25 25 25 00 00 25 25 25 25 00 00 25 25 25 25 10 25 00
00 25 10 25 25 25 25 25 25 25 25 25 25 25 25 25 25 25 25 25 25 25 25 25 25 25 25 25 25 25 25 25 21 21 21 21 21 21 25 25 25 25 25 25 25 25 25 25 25 25 25 25 25 25 25 25 25 25 25 25 25 10 25 00
00 25 10 25 25 25 25 25 25 25 25 25 25 25 25 25 25 25 25 25 25 25 25 25 25 25 25 25 25 25 25 25 21 21 21 21 21 21 25 25 25 25 25 25 25 25 25 25 25 25 25 25 25 25 25 25 25 25 25 25 25 10 25 00
00 25 10 25 25 25 25 25 25 25 25 25 25 25 25 25 25 25 25 25 25 25 25 25 25 25 25 25 25 25 25 25 25 21 21 21 21 25 25 25 25 25 25 25 25 25 25 25 25 25 25 25 25 25 25 25 25 25 25 25 25 10 25 00
00 25 10 25 25 25 25 25 25 25 25 25 25 25 25 25 25 25 25 25 25 25 25 25 25 25 25 25 25 25 25 25 25 21 21 21 21 25 25 25 25 25 25 25 25 25 25 25 25 25 25 25 25 25 25 25 25 25 25 25 25 10 25 00
00 25 10 25 25 25 25 00 00 25 25 25 25 00 00 25 25 25 25 00 00 25 25 25 25 00 00 25 25 25 25 00 00 25 25 25 25 00 00 25 25 25 25 00 00 00 25 25 00 00 00 25 25 25 25 00 00 25 25 25 25 10 25 00
00 25 10 25 25 25 25 00 00 25 25 25 25 00 00 25 25 25 25 00 00 25 25 25 25 00 00 25 25 25 25 00 00 25 25 25 25 00 00 25 25 25 25 00 00 25 25 25 25 00 00 25 25 25 25 00 00 25 25 25 25 10 25 00
00 25 10 25 25 25 25 25 25 25 25 25 25 25 25 25 25 25 25 25 25 25 25 25 25 25 25 25 25 25 25 00 25 25 25 25 25 25 00 25 25 25 25 00 25 25 25 25 25 25 00 25 25 25 25 25 25 25 25 25 25 10 25 00
00 25 10 25 25 25 25 25 25 25 25 25 25 25 25 25 25 25 25 25 25 25 25 25 25 25 25 25 25 25 25 00 25 25 25 25 25 25 00 25 25 25 25 25 25 25 25 25 25 25 25 25 25 25 25 25 25 25 25 25 25 10 25 00
00 25 10 25 25 25 25 25 25 25 25 25 25 25 25 25 25 25 25 25 25 25 25 25 25 25 25 25 25 25 25 00 25 25 25 25 25 25 00 25 25 25 25 25 25 25 25 25 25 25 25 25 25 25 25 25 25 25 25 25 25 10 25 00
00 25 10 25 25 25 25 25 25 25 25 25 25 25 25 25 25 25 25 25 25 25 25 25 25 25 25 25 25 25 25 00 25 25 25 25 25 25 00 25 25 25 25 00 25 25 25 25 25 25 00 25 25 25 25 25 25 25 25 25 25 10 25 00
00 25 10 25 25 25 25 00 00 25 25 25 25 00 00 25 25 25 25 00 00 25 25 25 25 00 00 25 25 25 25 00 00 25 25 25 25 00 00 25 25 25 25 00 00 25 25 25 25 00 00 25 25 25 25 00 00 25 25 25 25 10 25 00
00 25 10 25 25 25 25 00 00 25 25 25 25 00 00 25 25 25 25 00 00 25 25 25 25 00 00 25 25 25 25 00 00 25 25 25 25 00 00 25 25 25 25 00 00 00 25 25 00 00 00 25 25 25 25 00 00 25 25 25 25 10 25 00
00 25 10 25 25 25 33 25 25 25 25 25 25 25 25 25 25 25 25 25 25 25 25 25 25 25 25 25 25 25 25 25 25 25 25 25 25 25 33 25 25 25 25 25 25 25 25 25 25 25 25 25 25 25 25 25 25 33 25 25 25 10 25 00
00 25 10 25 25 25 25 25 25 25 25 25 25 25 25 25 25 25 25 25 25 25 25 25 25 25 25 25 25 25 25 25 25 25 25 25 25 25 25 25 25 25 25 25 25 25 25 25 25 25 25 25 25 25 25 25 25 25 25 25 25 10 25 00
00 25 10 25 25 25 25 25 25 25 25 25 25 25 25 25 25 25 25 25 25 25 25 25 25 25 25 25 25 25 25 25 25 25 25 25 25 25 25 25 25 25 25 25 25 25 25 25 25 25 25 25 25 25 25 25 25 25 25 25 25 10 25 00
00 25 10 25 25 25 25 25 25 25 25 25 25 25 25 25 25 25 25 25 25 25 25 25 25 25 25 25 25 25 25 25 25 25 25 25 25 25 25 25 25 25 25 25 25 25 25 25 25 25 25 25 25 25 25 25 25 25 25 25 25 10 25 00
00 25 10 10 10 10 10 10 10 10 10 10 10 10 10 10 10 10 10 10 10 10 10 10 10 10 10 10 10 10 10 10 10 10 10 10 10 10 10 10 10 10 10 10 10 10 10 10 10 10 10 10 10 10 10 10 10 10 10 10 10 10 25 00
00 25 25 25 25 25 25 25 25 25 25 25 25 25 25 25 25 25 25 25 25 25 25 25 25 25 25 25 25 25 25 25 25 25 25 25 25 25 25 25 25 25 25 25 25 25 25 25 25 25 25 25 25 25 25 25 25 25 25 25 25 25 25 00
00 00 00 00 00 00 00 00 00 00 00 00 00 00 00 00 00 00 00 00 00 00 00 00 00 00 00 00 00 00 00 00 00 00 00 00 00 00 00 00 00 00 00 00 00 00 00 00 00 00 00 00 00 00 00 00 00 00 00 00 00 00 00 00