00 00 00 00 00 00 00 00 00 00 00 00 00 00 00 00 00 00 00 00 00 00 00 00 00 00 00 00 00 00 00 00 00 00 00 00 00 00 00 00 00 00 00 00 00 00 00 00 00 00 00 00 00 00 00 00 00 00 00 00 00 00 00 00
00 10 10 10 10 10 10 10 10 10 10 10 10 10 10 10 10 10 10 10 10 10 10 10 10 10 10 10 10 10 10 10 10 10 10 10 10 10 10 10 10 10 10 10 10 10 10 10 10 10 10 10 10 10 10 10 10 10 10 10 10 10 10 00
00 10 10 10 10 10 10 10 10 10 10 10 10 10 10 10 10 10 10 10 10 10 10 10 10 10 10 10 10 10 10 10 10 10 10 10 10 10 10 10 10 10 10 10 10 10 10 10 10 10 10 10 10 10 10 10 10 10 10 10 10 10 10 00
00 10 10 20 20 20 20 20 20 20 20 20 20 20 20 20 20 20 20 20 20 20 20 20 20 20 20 20 20 20 20 20 20 20 20 20 20 20 20 20 20 20 20 20 20 20 20 20 20 20 20 20 20 20 20 20 20 20 20 20 20 10 10 00
00 10 10 20 20 20 20 20 20 20 20 20 20 20 20 20 20 20 20 20 20 20 20 20 20 20 20 20 20 20 20 20 20 20 20 20 20 20 20 20 20 20 20 20 20 20 20 20 20 20 20 20 20 20 20 20 20 20 20 20 20 10 10 00
00 10 10 20 20 20 20 20 20 20 20 20 20 20 20 20 20 20 20 20 20 20 20 20 20 20 20 20 20 20 20 20 20 20 20 20 20 20 20 20 20 20 20 20 20 20 20 20 20 20 20 20 20 20 20 20 20 20 20 20 20 10 10 00
00 10 10 20 20 20 20 20 20 20 20 20 20 20 20 20 20 20 20 20 20 20 20 20 20 20 20 20 20 20 20 20 20 20 20 20 20 20 20 20 20 20 20 20 20 20 20 20 20 20 20 20 20 20 20 20 20 20 20 20 20 10 10 00
00 10 10 20 20 20 20 20 20 20 20 20 20 20 20 20 20 20 20 20 20 20 20 20 20 20 20 20 20 20 20 20 20 20 20 20 20 20 20 20 20 20 20 20 20 20 20 20 20 20 20 20 20 20 20 20 20 20 20 20 20 10 10 00
00 10 10 20 20 20 20 20 20 20 20 20 20 20 20 20 20 20 20 20 20 20 20 20 20 20 20 20 20 20 20 20 20 20 20 20 20 20 20 20 20 20 20 20 20 20 20 20 20 20 20 20 20 20 20 20 20 20 20 20 20 10 10 00
00 10 10 20 20 20 20 20 20 20 20 20 20 20 20 20 20 20 20 20 20 20 20 20 20 20 20 20 20 20 20 20 20 20 20 20 20 20 20 20 20 20 20 20 20 20 20 20 20 20 20 20 20 20 20 20 20 20 20 20 20 10 10 00
00 10 10 20 20 20 20 20 22 22 22 22 22 22 22 22 22 22 22 22 22 22 22 22 22 22 22 22 22 22 22 22 22 22 22 22 22 22 22 22 22 22 22 22 22 22 22 22 22 22 22 22 22 22 22 22 22 22 20 20 20 10 10 00
00 10 10 20 20 20 20 22 22 22 22 22 22 22 22 22 22 22 22 22 22 22 22 22 22 22 22 22 22 22 22 22 22 22 22 22 22 22 22 22 22 22 22 22 22 22 22 22 22 22 22 22 22 22 22 22 22 22 22 20 20 10 10 00
00 10 10 20 20 20 20 22 22 22 22 22 22 22 22 22 22 22 22 22 22 22 22 22 22 22 22 22 22 22 22 22 22 22 22 22 22 22 22 22 22 22 22 22 22 22 22 22 22 22 22 22 22 22 22 22 22 22 22 20 20 10 10 00
00 10 10 20 20 20 20 22 22 22 22 22 22 22 22 22 22 22 22 22 22 22 22 22 22 22 22 22 22 22 22 22 22 22 22 22 22 22 22 22 22 22 22 22 22 22 22 22 22 22 22 22 22 22 22 22 22 22 22 20 20 10 10 00
00 10 10 20 20 20 20 22 22 22 22 22 22 22 22 22 22 22 22 22 22 22 22 22 22 22 22 22 22 22 22 22 22 22 22 22 22 22 22 22 22 22 22 22 22 22 22 22 22 22 22 22 22 22 22 22 22 22 22 20 20 10 10 00
00 10 10 20 20 20 20 22 22 22 22 22 22 22 22 22 22 22 22 22 22 22 22 22 22 22 22 22 22 22 22 22 22 22 22 22 22 22 22 22 22 22 22 22 22 22 22 22 22 22 22 22 22 22 22 22 22 22 22 22 20 10 10 00
00 10 10 20 20 20 20 00 00 00 00 00 00 00 00 00 00 00 00 00 00 00 00 00 00 00 00 21 21 21 21 00 00 00 00 00 00 00 00 00 00 00 00 00 00 21 21 21 21 00 00 00 00 00 00 00 00 25 25 25 25 10 10 00
00 10 10 20 20 20 20 00 23 23 23 23 23 23 23 23 23 23 23 23 23 23 23 23 23 23 23 23 23 23 23 23 23 23 00 24 24 24 24 24 24 24 00 24 24 24 24 24 24 24 24 24 24 24 24 24 00 25 25 25 25 10 10 00
00 10 10 20 20 20 20 00 23 23 23 23 23 23 23 23 23 23 23 23 23 23 23 23 23 23 23 23 23 23 23 23 23 23 00 24 24 24 24 24 24 24 00 24 24 24 24 24 24 24 24 24 24 24 24 24 00 25 25 25 25 10 10 00
00 10 10 20 20 20 20 00 23 23 23 23 23 23 23 23 23 23 23 23 23 23 23 23 23 23 23 23 23 23 23 23 23 23 00 24 24 24 24 24 24 24 00 24 24 24 24 24 24 24 24 24 24 24 24 24 00 25 25 25 25 10 10 00
00 10 10 20 20 20 20 00 23 23 23 23 23 23 23 23 23 23 23 23 23 23 23 23 23 23 23 23 23 23 23 23 23 23 00 24 24 24 24 24 24 24 00 24 24 24 24 24 24 24 24 24 24 24 24 24 00 25 25 25 25 10 10 00
00 10 10 20 20 20 20 00 23 23 23 23 23 23 23 23 23 23 23 23 23 23 23 23 23 23 23 23 23 23 23 23 23 23 00 24 24 24 24 24 24 24 00 24 24 24 24 24 24 24 24 24 24 24 24 24 00 25 25 25 25 10 10 00
00 10 10 20 20 20 20 00 23 23 23 23 23 23 23 23 23 23 23 23 23 23 23 23 23 23 23 23 23 23 23 23 23 23 00 24 24 24 24 24 24 24 00 24 24 24 24 24 24 24 24 24 24 24 24 24 00 25 25 25 25 10 10 00
00 10 10 20 20 20 20 00 23 23 23 23 23 23 23 23 23 23 23 23 23 23 23 23 23 23 23 23 23 23 23 23 23 23 00 24 24 24 24 24 24 24 00 24 24 24 24 24 24 24 24 24 24 24 24 24 00 25 25 25 25 10 10 00
00 10 10 20 20 20 20 00 23 23 23 23 23 23 23 23 23 23 23 23 23 23 23 23 23 23 23 23 23 23 23 23 23 23 00 24 24 24 24 24 24 24 00 24 24 24 24 24 24 24 24 24 24 24 24 24 00 25 25 25 25 10 10 00
00 10 10 20 20 20 20 00 23 23 23 23 23 23 23 23 23 23 23 23 23 23 23 23 23 23 23 23 23 23 23 23 23 23 00 24 24 24 24 24 24 24 00 24 24 24 24 24 24 24 24 24 24 24 24 24 00 25 25 25 25 10 10 00
00 10 10 20 20 20 20 00 23 23 23 23 23 23 23 23 23 23 23 23 23 23 23 23 23 23 23 23 23 23 23 23 23 23 00 24 24 24 24 24 24 24 00 24 24 24 24 24 24 24 24 24 24 24 24 24 00 25 25 25 25 10 10 00
00 10 10 20 20 20 20 21 23 23 23 23 23 23 23 23 23 23 23 23 23 23 23 23 23 23 23 23 23 23 23 23 23 23 00 24 24 24 24 24 24 24 00 24 24 24 24 24 24 24 24 24 24 24 24 24 00 25 25 25 25 10 10 00
00 10 10 20 20 20 20 21 23 23 23 23 23 23 23 23 23 23 23 23 23 23 23 23 23 23 23 23 23 23 23 23 23 23 00 24 24 24 24 24 24 24 00 24 24 24 24 24 24 24 24 24 24 24 24 24 00 25 25 25 25 10 10 00
00 10 10 20 20 20 20 21 23 23 23 23 23 23 23 23 23 23 23 23 23 23 23 23 23 23 23 23 23 23 23 23 23 21 21 24 24 24 24 24 24 24 00 24 24 24 24 24 24 24 24 24 24 24 24 24 00 25 25 25 25 10 10 00
00 10 10 20 20 20 20 21 23 23 23 23 23 23 23 23 23 23 23 23 23 23 23 23 23 23 23 23 23 23 23 23 23 21 21 24 24 24 24 24 24 24 00 24 24 24 24 24 24 24 24 24 24 24 24 24 00 25 25 25 25 10 10 00
00 10 10 20 20 20 20 00 23 23 23 23 23 23 23 23 23 23 23 23 23 23 23 23 23 23 23 23 23 23 23 23 23 21 21 24 24 24 24 24 24 24 00 24 24 24 24 24 24 24 24 24 24 24 24 24 00 25 25 25 25 10 10 00
00 10 10 20 20 20 20 00 23 23 23 23 23 23 23 23 23 23 23 23 23 23 23 23 23 23 23 23 23 23 23 23 23 21 21 24 24 24 24 24 24 24 00 24 24 24 24 24 24 24 24 24 24 24 24 24 00 25 25 25 25 10 10 00
00 10 10 20 20 20 20 00 23 23 23 23 23 23 23 23 23 23 23 23 23 23 23 23 23 23 23 23 23 23 23 23 23 23 00 24 24 24 24 24 24 24 00 24 24 24 24 24 24 24 24 24 24 24 24 24 00 25 25 25 25 10 10 00
00 10 10 20 20 20 20 00 23 23 23 23 23 23 23 23 23 23 23 23 23 23 23 23 23 23 23 23 23 23 23 23 23 23 00 24 24 24 24 24 24 24 00 24 24 24 24 24 24 24 24 24 24 24 24 24 00 25 25 25 25 10 10 00
00 10 10 20 20 20 20 00 00 00 00 00 00 00 00 00 00 00 00 00 00 23 23 23 23 23 23 23 23 23 23 23 23 23 00 24 24 24 24 24 24 24 00 24 24 24 24 24 24 24 24 24 24 24 24 24 00 25 25 25 25 10 10 00
00 10 10 20 20 20 20 00 23 23 23 23 23 23 23 23 23 23 23 23 00 23 23 23 23 23 23 23 23 23 23 23 23 23 00 24 24 24 24 24 24 24 00 24 24 24 24 24 24 24 24 24 24 24 24 24 00 25 25 25 25 10 10 00
00 10 10 20 20 20 20 00 23 23 23 23 23 23 23 23 23 23 23 23 00 23 23 23 23 23 23 23 23 23 23 23 23 23 00 24 24 24 24 24 24 24 00 24 24 24 24 24 24 24 24 24 24 24 24 24 00 25 25 25 25 10 10 00
00 10 10 20 20 20 20 00 23 23 23 23 23 23 23 23 23 23 23 23 00 23 23 23 23 23 23 23 23 23 23 23 23 23 00 24 24 24 24 24 24 24 00 24 24 24 24 24 24 24 24 24 24 24 24 24 00 25 25 25 25 10 10 00
00 10 10 20 20 20 20 00 23 23 23 23 23 23 23 23 23 23 23 23 23 23 23 23 23 23 23 23 23 23 23 23 23 23 00 24 24 24 24 24 24 24 00 24 24 24 24 24 24 24 24 24 24 24 24 24 00 25 25 25 25 10 10 00
00 10 10 20 20 20 20 00 23 23 23 23 23 23 23 23 23 23 23 23 23 23 23 23 23 23 23 23 23 23 23 23 23 23 00 24 24 24 24 24 24 24 00 24 24 24 24 24 24 24 24 24 24 24 24 24 00 25 25 25 25 10 10 00
00 10 10 20 20 20 20 00 23 23 23 23 23 23 23 23 23 23 23 23 23 23 23 23 23 23 23 23 23 23 23 23 23 23 00 24 24 24 24 24 24 24 00 24 24 24 24 24 24 24 24 24 24 24 24 24 00 25 25 25 25 10 10 00
00 10 10 20 20 20 20 00 23 23 23 23 23 23 23 23 23 23 23 23 23 23 23 23 23 23 23 23 23 23 23 23 23 23 00 24 24 24 24 24 24 24 00 24 24 24 24 24 24 24 24 24 24 24 24 24 00 25 25 25 25 10 10 00
00 10 10 20 20 20 20 00 23 23 23 23 23 23 23 23 23 23 23 23 00 23 23 23 23 23 23 23 23 23 23 23 23 23 00 24 24 24 24 24 24 24 24 24 24 24 24 24 24 24 24 24 24 24 24 24 00 25 25 25 25 10 10 00
00 10 10 20 20 20 20 00 23 23 23 23 23 23 23 23 23 23 23 23 00 23 23 23 23 23 23 23 23 23 23 23 23 23 00 24 24 24 24 24 24 24 24 24 24 24 24 24 24 24 24 24 24 24 24 24 00 25 25 25 25 10 10 00
00 10 10 20 20 20 20 00 23 23 23 23 23 23 23 23 23 23 23 23 00 23 23 23 23 23 23 23 23 23 23 23 23 23 00 24 24 24 24 24 24 24 24 24 24 24 24 24 24 24 24 24 24 24 24 24 00 25 25 25 25 10 10 00
00 10 10 20 20 20 20 00 23 23 23 23 23 23 23 23 23 23 23 23 00 23 23 23 23 23 23 23 23 23 23 23 23 23 00 24 24 24 24 24 24 24 24 24 24 24 24 24 24 24 24 24 24 24 24 24 00 25 25 25 25 10 10 00
00 10 10 20 20 20 20 00 23 23 23 23 23 23 23 23 23 23 23 23 00 23 23 23 23 23 23 23 23 23 23 23 23 23 00 24 24 24 24 24 24 24 24 24 24 24 24 24 24 24 24 24 24 24 24 24 00 25 25 25 25 10 10 00
00 10 10 20 20 20 20 00 00 00 00 00 00 00 00 00 00 00 00 00 00 00 00 00 00 00 00 21 21 21 21 00 00 00 00 00 00 00 00 00 00 00 00 00 00 00 00 00 00 00 00 00 00 00 00 00 00 25 25 25 25 10 10 00
00 10 10 20 20 20 20 21 21 21 21 21 21 21 21 21 21 21 21 21 21 21 21 21 21 21 21 21 21 21 21 21 21 21 21 21 21 21 21 21 21 21 21 21 21 21 21 21 21 21 21 21 21 21 21 21 21 25 25 25 25 10 10 00
00 10 10 20 20 20 20 21 21 21 21 21 21 21 21 21 21 21 21 21 21 21 21 21 21 21 21 21 21 21 21 21 21 21 21 21 21 21 21 21 21 21 21 21 21 21 21 21 21 21 21 21 21 21 21 21 21 25 25 25 25 10 10 00
00 10 10 10 10 10 10 10 10 10 10 10 10 10 10 10 10 10 10 10 10 10 10 10 10 10 10 10 10 10 10 10 10 10 10 10 10 10 10 10 10 10 10 10 10 10 10 10 10 10 10 10 10 10 10 10 10 10 10 10 10 10 10 00
00 10 10 10 10 10 10 10 10 10 10 10 10 10 10 10 10 10 10 10 10 10 10 10 10 10 10 10 10 10 10 10 10 10 10 10 10 10 10 10 10 10 10 10 10 10 10 10 10 10 10 10 10 10 10 10 10 10 10 10 10 10 10 00
00 00 00 00 00 00 00 00 00 00 00 00 00 00 00 00 00 00 00 00 00 00 00 00 00 00 00 00 00 00 00 00 00 00 00 00 00 00 00 00 00 00 00 00 00 00 00 00 00 00 00 00 00 00 00 00 00 00 00 00 00 00 00 00