00 00 00 00 00 00 00 00 00 00 00 00 00 00 00 00 00 00 00 00 00 00 00 00 00 00 00 00 00 00 00 00 00 00 00 00 00 00 00 00 00 00 00 00 00 00 00 00 00 00 00 00 00 00 00 00 00 00 00 00 00 00 00 00
00 25 25 25 25 25 25 25 25 25 25 25 25 25 25 25 25 25 25 25 25 25 25 25 25 25 25 25 25 25 25 25 25 25 25 25 25 25 25 25 25 25 25 25 25 25 25 25 25 25 25 25 25 25 25 25 25 25 25 25 25 25 25 00
00 25 10 10 10 10 10 10 10 10 10 10 10 10 10 10 10 10 10 10 10 10 10 10 10 10 10 10 10 10 10 10 10 10 10 10 10 10 10 10 10 10 10 10 10 10 10 10 10 10 10 10 10 10 10 10 10 10 10 10 10 10 25 00
00 25 10 25 25 25 25 25 25 25 25 25 25 25 25 25 25 25 25 25 25 25 25 25 25 25 25 25 25 25 25 25 25 25 25 25 25 25 25 25 25 25 25 25 25 25 25 25 25 25 25 25 25 25 25 25 25 25 25 25 25 10 25 00
00 25 10 25 25 25 25 25 25 25 25 25 25 25 25 25 25 25 25 25 25 25 25 25 25 25 25 25 25 25 25 25 25 25 25 25 25 25 25 25 25 25 25 25 25 25 25 25 25 25 25 25 25 25 25 25 25 25 25 25 25 10 25 00
00 25 10 25 25 25 25 25 25 25 25 25 25 25 25 25 25 25 25 25 25 25 25 25 25 25 25 25 25 25 25 25 25 25 25 25 25 25 25 25 25 25 25 25 25 25 25 25 25 25 25 25 25 25 25 25 25 25 25 25 25 10 25 00
00 25 10 25 25 25 35 25 25 25 25 25 25 25 25 25 25 25 25 25 25 25 25 25 25 25 35 25 25 25 25 25 25 25 25 25 25 25 25 25 25 25 25 35 25 25 25 25 25 25 25 25 25 25 25 25 25 35 25 25 25 10 25 00
00 25 10 25 25 25 25 00 00 25 25 25 25 00 00 00 25 25 00 00 00 25 25 25 25 00 00 25 25 25 25 00 00 25 25 25 25 00 00 25 25 25 25 00 00 25 25 25 25 00 00 00 25 25 25 00 00 25 25 25 25 10 25 00
00 25 10 25 25 25 25 00 00 25 25 25 25 00 00 25 25 25 25 00 00 25 25 25 25 00 00 25 25 25 25 00 00 25 25 25 25 00 00 25 25 25 25 00 00 25 25 25 25 00 00 25 25 25 25 00 00 25 25 25 25 10 25 00
00 25 10 25 25 25 25 25 25 25 25 25 25 00 25 25 25 25 25 25 00 25 25 25 25 25 25 25 25 25 25 00 25 25 25 25 25 25 00 25 25 25 25 25 25 25 25 25 25 25 25 25 25 25 25 25 25 25 25 25 25 10 25 00
00 25 10 25 25 25 25 25 25 25 25 25 25 25 25 25 25 25 25 25 25 25 25 25 25 25 25 25 25 25 25 00 25 25 25 25 25 25 00 25 25 25 25 25 25 25 25 25 25 25 25 25 25 25 25 25 25 25 25 25 25 10 25 00
00 25 10 25 25 25 25 25 25 25 25 25 25 25 25 25 25 25 25 25 25 25 25 25 25 25 25 25 25 25 25 00 25 25 25 25 25 25 00 25 25 25 25 25 25 25 25 25 25 25 25 25 25 25 25 25 25 25 25 25 25 10 25 00
00 25 10 25 25 25 25 25 25 25 25 25 25 00 25 25 25 25 25 25 00 25 25 25 25 25 25 25 25 25 25 00 25 25 25 25 25 25 00 25 25 25 25 25 25 25 25 25 25 25 25 25 25 25 25 25 25 25 25 25 25 10 25 00
00 25 10 25 25 25 25 00 00 25 25 25 25 00 00 25 25 25 25 00 00 25 25 25 25 00 00 25 25 25 25 00 00 25 25 25 25 00 00 25 25 25 25 00 00 25 25 25 25 00 00 00 25 25 00 00 00 25 25 25 25 10 25 00
00 25 10 25 25 25 25 00 00 25 25 25 25 00 00 00 25 25 00 00 00 25 25 25 25 00 00 25 25 25 25 00 00 25 25 25 25 00 00 25 25 25 26 00 00 25 25 25 25 00 00 25 25 25 25 00 00 25 25 25 25 10 25 00
00 25 10 26 25 25 25 26 25 25 25 25 25 25 25 25 25 25 25 25 25 25 25 25 25 25 25 25 25 25 25 25 25 25 25 25 25 25 25 25 25 25 25 25 25 25 25 25 25 00 25 25 25 25 25 25 00 25 25 25 25 10 25 00
00 25 10 25 25 25 25 25 25 25 25 25 25 25 25 25 25 25 25 25 25 25 25 25 25 25 25 25 25 25 25 25 25 25 25 25 25 25 25 25 25 25 25 25 25 25 25 25 25 25 25 25 25 25 25 25 25 25 25 25 25 25 25 00
00 25 10 25 25 25 25 25 25 25 25 25 25 25 25 25 25 25 25 25 25 25 25 25 25 25 25 25 25 25 25 25 25 25 25 25 25 25 25 25 25 25 25 25 25 25 25 25 25 25 25 25 25 25 25 25 25 25 25 25 00 00 00 00
00 25 10 25 25 25 25 25 25 25 25 25 25 25 25 25 25 25 25 25 25 25 25 25 25 25 25 25 25 25 25 25 25 25 25 25 25 25 25 25 25 25 25 25 25 25 25 25 25 00 25 25 25 25 25 25 00 25 25 00 00 00 00 00
00 25 10 25 25 25 25 00 00 25 25 25 25 00 00 25 25 25 25 00 00 25 25 25 25 00 00 25 25 25 25 00 00 25 25 25 25 00 00 25 25 25 25 00 00 25 25 25 25 00 00 25 25 25 25 00 00 25 25 25 25 00 00 00
00 25 10 25 25 25 25 00 00 25 25 25 25 00 00 25 25 25 25 00 00 25 25 25 25 00 00 25 25 25 25 00 00 25 25 25 25 00 00 27 25 25 25 00 00 25 25 25 25 00 00 00 25 25 00 00 00 25 25 25 25 25 25 00
00 25 10 25 25 25 25 25 25 25 25 25 25 25 25 25 25 25 25 25 25 25 25 25 25 25 25 25 25 25 25 00 21 21 21 21 21 21 00 25 25 25 25 25 25 25 25 25 25 25 25 25 25 25 25 25 25 25 25 25 25 10 25 00
00 25 10 25 25 25 25 25 25 25 25 25 25 25 25 25 25 25 25 25 25 25 25 25 25 25 25 25 25 25 25 00 21 21 21 21 21 21 00 25 25 25 25 25 25 25 25 25 25 25 25 25 25 25 25 25 25 25 25 25 25 10 25 00
00 25 10 25 25 25 25 25 25 25 25 25 25 25 25 25 25 25 25 25 25 25 25 25 25 25 25 25 25 25 25 00 21 21 21 21 21 21 00 25 25 25 25 25 25 25 25 25 25 25 25 25 25 25 25 25 25 25 25 25 25 10 25 00
00 25 10 25 25 25 25 25 25 25 25 25 25 25 25 25 25 25 25 25 25 25 25 25 25 25 25 25 25 25 25 25 21 21 21 31 21 21 25 25 25 25 25 25 25 25 25 25 25 25 25 25 25 25 25 25 25 25 25 25 25 10 25 00
00 25 10 25 25 25 25 00 00 25 25 25 25 00 00 00 00 00 00 00 00 25 25 25 25 00 00 25 25 25 25 25 21 21 00 00 21 21 25 25 25 25 25 00 00 25 25 25 25 00 00 25 25 25 25 00 00 25 25 25 25 10 25 00
00 25 10 25 25 25 25 00 00 25 25 25 25 00 00 25 25 25 25 00 00 25 25 25 25 00 00 00 00 00 00 00 21 21 00 00 21 21 00 00 00 00 00 00 00 25 25 25 25 00 00 25 25 25 25 00 00 35 25 25 25 10 25 00
00 25 10 25 25 25 25 25 25 25 25 25 25 25 25 25 25 25 25 25 25 25 25 25 25 25 00 21 21 21 21 21 21 21 21 21 21 21 21 21 21 21 21 00 25 25 25 25 25 25 25 25 25 25 25 25 25 25 25 25 25 10 25 00
00 25 10 25 25 25 25 25 25 25 25 25 25 25 25 25 25 25 25 25 25 25 25 25 25 25 00 21 21 21 21 21 21 21 21 21 21 21 21 21 21 21 21 00 25 25 25 25 25 25 25 25 25 25 25 25 25 25 25 25 25 10 25 00
00 25 10 25 25 25 25 25 25 25 25 25 25 25 25 25 25 25 25 25 25 25 25 25 25 25 00 21 21 21 21 21 21 21 21 21 21 21 21 21 21 21 21 00 25 25 25 25 25 25 25 25 25 25 25 25 25 25 25 25 25 10 25 00
00 25 10 25 25 25 25 25 25 25 25 25 25 25 25 25 25 25 25 25 25 25 25 25 25 25 00 21 21 21 21 21 31 21 21 21 21 21 31 21 21 21 21 00 25 25 25 25 25 25 25 25 25 25 25 25 25 25 25 25 25 10 25 00
00 25 10 25 25 25 25 00 00 25 25 25 25 00 00 25 25 25 25 00 00 25 25 25 25 25 00 21 21 21 21 00 00 21 21 21 21 00 00 21 21 21 21 00 25 25 25 25 25 00 00 00 00 00 00 00 00 25 25 25 25 10 25 00
00 25 10 25 25 25 25 00 00 25 25 25 25 00 00 25 25 25 25 00 00 25 25 21 21 21 21 21 21 21 31 00 00 21 21 21 21 00 00 31 21 21 21 21 21 21 21 25 25 00 00 25 25 25 25 00 00 25 25 25 25 10 25 00
00 25 10 25 25 25 25 25 25 25 25 25 25 25 25 25 25 25 25 25 25 21 21 21 21 21 21 21 21 21 21 21 21 31 21 21 31 21 21 21 21 21 21 21 21 21 21 21 21 25 25 25 25 25 25 25 25 25 25 25 25 10 25 00
00 25 10 25 25 25 25 25 25 25 25 25 25 25 25 25 25 25 25 25 25 21 21 21 21 21 00 21 21 21 21 21 21 21 41 51 21 21 21 21 21 21 21 00 21 21 21 21 21 25 25 25 25 25 25 25 25 25 25 25 25 10 25 00
00 25 10 25 25 25 25 25 25 25 25 25 25 25 25 25 25 25 25 25 25 21 21 21 21 21 00 31 21 21 21 21 21 21 42 52 21 21 21 21 21 21 31 00 21 21 21 21 21 25 25 25 25 25 25 25 25 25 25 25 25 10 25 00
00 25 10 25 25 25 25 25 25 25 25 25 25 25 25 25 25 25 25 25 25 21 21 21 21 21 21 21 21 21 21 21 21 31 21 21 31 21 21 21 21 21 21 21 21 21 21 21 21 25 25 25 25 25 25 25 25 25 25 25 25 10 25 00
00 25 10 25 25 25 25 00 00 00 25 25 00 00 00 25 25 25 25 00 00 25 25 21 21 21 21 21 21 21 31 00 00 21 21 21 21 00 00 31 21 21 21 21 21 21 21 25 25 00 00 25 25 25 27 00 00 25 25 25 25 10 25 00
00 25 10 25 25 25 25 00 00 25 25 25 25 00 00 25 25 25 25 00 00 25 25 25 25 25 00 21 21 21 21 00 00 21 21 21 21 00 00 21 21 21 21 00 25 25 25 25 25 00 00 00 00 00 00 00 00 25 25 25 25 10 25 00
00 25 10 25 25 25 25 00 25 25 25 25 25 25 00 25 25 25 25 25 25 25 25 25 25 25 00 21 21 21 21 21 31 21 21 21 21 31 21 21 21 21 21 00 25 25 25 25 25 25 25 25 25 25 25 25 25 25 25 25 25 10 25 00
00 25 10 25 25 25 25 25 25 25 26 25 25 25 25 25 25 25 25 25 25 25 25 25 25 25 00 21 21 21 21 21 21 21 21 21 21 21 21 21 21 21 21 00 25 25 25 25 25 25 25 25 25 25 25 25 25 25 25 25 25 10 25 00
00 25 10 25 25 25 25 25 25 25 25 27 25 25 25 25 25 25 25 25 25 25 25 25 25 25 00 21 21 21 21 21 21 21 21 21 21 21 21 21 21 21 21 00 25 25 25 25 25 25 25 25 25 25 25 25 25 25 25 25 25 10 25 00
00 25 10 25 25 25 25 00 25 25 25 25 25 25 00 25 25 25 25 25 25 25 25 25 25 25 00 21 21 21 21 21 21 21 21 31 21 21 21 21 21 21 21 00 25 25 25 25 25 25 25 25 25 25 25 25 25 25 25 25 25 10 25 00
00 25 10 25 25 25 25 00 00 25 25 25 25 00 00 25 25 25 25 00 00 25 25 25 25 00 00 00 00 00 00 00 21 21 00 00 21 21 00 00 00 00 00 00 00 25 25 25 25 00 00 25 25 25 25 00 00 25 25 25 25 10 25 00
00 25 10 25 25 25 25 00 00 00 25 25 00 00 00 25 25 25 25 00 00 25 25 25 25 00 00 25 25 25 25 25 21 21 00 00 21 21 25 25 25 25 25 00 00 25 25 25 25 00 00 25 25 25 25 00 00 25 25 25 25 10 25 00
00 25 10 25 25 25 25 25 25 25 25 25 25 25 25 25 25 25 25 25 25 25 25 25 25 25 25 25 25 25 25 25 21 21 21 21 21 21 25 25 25 25 25 25 25 25 25 25 25 25 25 25 25 25 25 25 25 25 25 25 25 10 25 00
00 25 10 25 25 25 25 25 25 25 25 25 25 25 25 25 25 25 25 25 25 25 25 25 25 25 25 25 25 25 25 25 21 21 21 21 21 21 25 25 25 25 25 25 25 25 25 25 25 25 25 25 25 25 25 25 25 25 25 25 25 10 25 00
00 25 10 25 25 25 25 25 25 25 25 25 25 25 25 25 25 25 25 25 25 25 25 25 25 25 25 25 25 25 25 25 25 21 21 21 21 25 25 25 25 25 25 25 25 25 25 25 25 25 25 25 25 25 25 25 25 25 25 25 25 10 25 00
00 25 10 25 25 25 25 25 25 25 25 25 25 25 25 25 25 25 25 25 25 25 25 25 25 25 25 25 25 25 25 25 25 21 21 21 21 25 25 25 25 25 25 25 25 25 25 25 25 25 25 25 25 25 25 25 25 25 25 25 25 10 25 00
00 25 10 25 25 25 25 00 00 25 25 25 25 00 00 25 25 25 25 00 00 25 25 25 25 00 00 25 25 25 25 00 00 25 25 25 25 00 00 25 25 25 25 00 00 00 25 25 00 00 00 25 25 25 25 00 00 25 25 25 25 10 25 00
00 25 10 25 25 25 25 00 00 25 25 25 25 00 00 25 25 25 25 00 00 25 25 25 25 00 00 25 25 25 25 00 00 25 25 25 25 00 00 25 25 25 25 00 00 25 25 25 25 00 00 25 25 25 25 00 00 25 25 25 25 10 25 00
00 25 10 25 25 25 25 25 25 25 25 25 25 25 25 25 25 25 25 25 25 25 25 25 25 25 25 25 25 25 25 00 25 25 25 25 25 25 00 25 25 25 25 00 25 25 25 25 25 25 00 25 25 25 25 25 25 25 25 25 25 10 25 00
00 25 10 25 25 25 25 25 25 25 25 25 25 25 25 25 25 25 25 25 25 25 25 25 25 25 25 25 25 25 25 00 25 25 25 25 25 25 00 25 25 25 25 25 25 25 25 25 25 25 25 25 25 25 25 25 25 25 25 25 25 10 25 00
00 25 10 25 25 25 25 25 25 25 25 25 25 25 25 25 25 25 25 25 25 25 25 25 25 25 25 25 25 25 25 00 25 25 25 26 25 25 00 25 25 25 25 25 25 25 25 25 25 25 25 25 25 25 25 25 25 25 25 25 25 10 25 00
00 25 10 25 25 25 25 25 25 25 25 25 25 25 25 25 25 25 25 25 25 25 25 25 25 25 25 25 25 25 25 00 25 25 25 25 25 25 00 25 25 25 25 00 25 25 25 25 25 25 00 25 25 25 25 25 25 25 25 25 25 10 25 00
00 25 10 25 25 25 25 00 00 25 25 25 25 00 00 25 25 25 25 00 00 25 25 25 25 00 00 25 25 25 25 00 00 25 25 25 25 00 00 25 25 25 25 00 00 25 25 25 26 00 00 25 25 25 25 00 00 25 25 25 25 10 25 00
00 25 10 25 25 25 25 00 00 25 25 25 25 00 00 25 25 25 25 00 00 25 25 25 25 00 00 25 25 25 25 00 00 25 25 25 25 00 00 25 25 25 25 00 00 00 25 25 00 00 00 25 25 25 25 00 00 25 25 25 25 10 25 00
00 25 10 25 25 25 35 25 25 25 25 25 25 25 25 25 25 25 25 25 25 25 25 25 25 25 25 25 25 25 25 25 25 25 25 25 25 25 35 25 25 25 25 25 25 25 25 25 25 25 25 25 25 25 25 25 27 35 25 25 25 10 25 00
00 25 10 25 25 25 25 25 25 25 25 25 25 25 25 25 25 25 25 25 25 25 25 25 25 25 25 25 25 25 25 25 25 25 25 25 25 25 25 25 25 25 25 25 25 25 25 25 25 25 25 25 25 25 25 25 25 25 25 25 25 10 25 00
00 25 10 25 25 25 25 25 25 25 25 25 25 25 25 25 25 25 25 25 25 25 25 25 25 25 25 25 25 25 25 25 25 25 25 25 25 25 25 25 25 25 25 25 25 25 25 25 25 25 25 25 25 25 25 25 25 25 25 25 25 10 25 00
00 25 10 25 25 25 25 25 25 25 25 25 25 25 25 25 25 25 25 25 25 25 25 25 25 25 25 25 25 25 25 25 25 25 25 25 25 25 25 25 25 25 25 25 25 25 25 25 25 25 25 25 25 25 25 25 25 25 25 25 25 10 25 00
00 25 10 10 10 10 10 10 10 10 10 10 10 10 10 10 10 10 10 10 10 10 10 10 10 10 10 10 10 10 10 10 10 10 10 10 10 10 10 10 10 10 10 10 10 10 10 10 10 10 10 10 10 10 10 10 10 10 10 10 10 10 25 00
00 25 25 25 25 25 25 25 25 25 25 25 25 25 25 25 25 25 25 25 25 25 25 25 25 25 25 25 25 25 25 25 25 25 25 25 25 25 25 25 25 25 25 25 25 25 25 25 25 25 25 25 25 25 25 25 25 25 25 25 25 25 25 00
00 00 00 00 00 00 00 00 00 00 00 00 00 00 00 00 00 00 00 00 00 00 00 00 00 00 00 00 00 00 00 00 00 00 00 00 00 00 00 00 00 00 00 00 00 00 00 00 00 00 00 00 00 00 00 00 00 00 00 00 00 00 00 00