00 00 00 00 00 00 00 00 00 00 00 00 00 00 00 00
00 23 23 23 23 23 23 23 23 23 23 23 23 23 23 00
00 23 33 33 23 23 23 23 23 23 23 23 23 23 23 00
00 23 23 23 23 23 23 23 23 23 23 23 23 23 23 00
00 23 23 23 23 23 23 23 23 23 23 23 23 23 23 00
00 23 23 23 23 23 23 23 23 23 23 23 23 23 23 00
00 23 23 23 23 23 23 23 23 23 23 23 23 23 23 00
00 23 23 23 23 23 23 10 10 23 23 23 23 23 23 00
00 23 23 23 23 23 23 10 10 23 23 23 23 23 23 00
00 23 23 23 23 23 23 23 23 23 23 23 23 23 23 00
00 23 23 23 23 23 23 23 23 23 23 23 23 23 23 00
00 23 23 23 23 23 23 23 23 23 23 23 23 23 23 00
00 23 23 23 23 23 23 23 23 23 23 23 23 23 23 00
00 23 23 23 23 23 23 23 23 23 23 23 23 23 23 00
00 23 23 23 23 23 23 23 23 23 23 23 23 23 23 00
00 00 00 00 00 00 00 00 00 00 00 00 00 00 00 00